{
  "level": [
    "################",
    "#              #",
    "#-  # ######## #",
    "# - #  #     | #",
    "### ####    |  #",
    "#  -   #   |   #",
    "# ####### ######",
    "#   #  -       #",
    "# k # # #  -   #",
    "####### ######i#",
    "#      -     # #",
    "## # -      ## #",
    "#   #   -  #a |#",
    "# s ### ###### #",
    "#   #   -  d   #",
    "################"
  ],
  "info": {
    "arrow": "up"
  }
}
